############################################################
#//////////////////////////////////////////////////////////#
#//////////////////////////////////////////////////////////#
#//////////////////////////////////////////////////////////#
#//////////////////////////////////////////////////////////#
#//////////////////////////////////////////////////////////#
#//////////////////////////////////////////////////////////#
#///////                                            ///////#
#///////                                            ///////#
#///////                                            ///////#
#///////                                            ///////#
#///////                                            ///////#
#///////                                            ///////#
#///////          G                                 ///////#
#///////                                            ///////#
#///////                                            ///////#
#///////                                            ///////#
#///////                                            ///////#
#///////                                            ///////#
#///////                                            ///////#
#///////                                            ///////#
#//////                                             ///////#
#////           ////////#///////                    ///////#
#////          /////////#///////                    ///////#
#////         //////////#///////                    ///////#
#////        ///////////#///////                    ///////#
#////       ////////////#///////                    ///////#
#////       ////////////#///////                    ///////#
#////       ////////////#///////                    ///////#
#////       ////////////#///////                    ///////#
#////       ////////////#///////                    ///////#
#////       ////////////#///////                    ///////#
#////       ////////////#///////                    ///////#
#////        ///////////#///////                    ///////#
#////         //////////#///////                    ///////#
#////          /////////#///////                    ///////#
#////           ////////#///////                    ///////#
#/////           ///////#///////                    ///////#
#//////          ///////#///////                    ///////#
#///////         ///////#///////                    ///////#
#///////         ///////#///////                    ///////#
#///////         ///////#///////                    ///////#
#///////         ///////#///////                    ///////#
#///////         ///////#///////                    ///////#
#///////         ///////#///////                    ///////#
#///////         ///////#///////                    ///////#
#///////         ///////#///////                    ///////#
#///////         ///////#///////                    ///////#
#///////         ///////#///////                    ///////#
#///////         ///////#///////    S               ///////#
#///////         ///////#///////                    ///////#
#///////         ///////#///////                    ///////#
#///////         ///////#///////                    ///////#
#///////         ///////#///////                    ///////#
#///////         ///////#///////                    ///////#
#///////         ///////#///////                    ///////#
#///////         ///////#///////                    ///////#
#///////         ///////#///////                    ///////#
#///////         ///////#///////                    ///////#
#///////         ///////#///////                    ///////#
#///////         ///////#///////                    ///////#
#///////         ///////#///////                    ///////#
#///////          //////#///////                    ///////#
#///////           /////#///////                    ///////#
#////////           ////#///////                    ///////#
#/////////          ////#///////                    ///////#
#//////////         ////#///////                    ///////#
#///////////        ////#///////                    ///////#
#////////////       ////#///////                    ///////#
#////////////       ////#///////                    ///////#
#////////////       ////#///////                    ///////#
#////////////       ////#///////                    ///////#
#////////////       ////#///////                    ///////#
#////////////       ////#///////                    ///////#
#////////////       ////#///////                    ///////#
#//////////         ////#///////                    ///////#
#/////////          ////#///////                    ///////#
#////////           ////#///////                    ///////#
#///////            ////////////                    ///////#
#///////            ////////////                    ///////#
#///////            ////////////                    ///////#
#///////            ////////////                    ///////#
#///////                                            ///////#
#///////                                            ///////#
#///////                                            ///////#
#///////                                            ///////#
#///////                                            ///////#
#///////                                            ///////#
#///////                                            ///////#
#///////                                            ///////#
#///////                                            ///////#
#///////                                            ///////#
#///////                                            ///////#
#//////////////////////////////////////////////////////////#
#//////////////////////////////////////////////////////////#
#//////////////////////////////////////////////////////////#
#//////////////////////////////////////////////////////////#
#//////////////////////////////////////////////////////////#
#//////////////////////////////////////////////////////////#
############################################################
