############################################################
#                                                          #
#                                                          #
#                                                          #
#                                                          #
#                                                          #
#                                                          #
#                                                          #
#                                                          #
#                                                          #
#                                                          #
#                                                          #
#                                                          #
#                                                          #
#                                                          #
#                                                          #
#                                                          #
#                                                          #
#                                                          #
#                    S                                     #
#                                                          #
#                  /////#                                  #
#                 //////#                                  #
#                ///////#                                  #
#               ////////#    G                             #
#              /////////#                                  #
#              /////////#                                  #
#              /////////#                                  #
#              /////////#                                  #
#              /////////#                                  #
#              /////////#                                  #
#              /////////#                                  #
#               ////////#                                  #
#                ///////#                                  #
#                 //////#                                  #
#                  /////#                                  #
#                       #                                  #
#                       #                                  #
#                       #                                  #
#                       #                                  #
#                       #                                  #
#                       #                                  #
#                       #                                  #
#                       #                                  #
#                       #                                  #
#                       #                                  #
#                       #                                  #
#                       #                                  #
#                       #                                  #
#                       #                                  #
#                       #                                  #
#                       #                                  #
#                       #                                  #
#                       #                                  #
#                       #                                  #
#                       #                                  #
#                       #                                  #
#                       #                                  #
#                       #                                  #
#                       #                                  #
#                       #                                  #
#                       #                                  #
#                       #                                  #
#/////                  #                                  #      
#//////                 #                                  #
#///////                #                                  #      
#////////               #                                  #
#/////////              #                                  #      
#/////////              #                                  #
#/////////              #                                  #      
#/////////              #                                  #
#/////////              #                                  #      
#/////////              #                                  #
#/////////              #                                  #      
#///////                #                                  #
#//////                 #                                  #      
#/////                  #                                  #
#                                                          #
#                                                          #
#                                                          #
#                                                          #
#                                                          #
#                                                          #
#                                                          #
#                                                          #
#                                                          #
#                                                          #
#                                                          #
#                                                          #
#                                                          #
#                                                          #
#                                                          #
#                                                          #
#                                                          #
#                                                          #
#                                                          #
#                                                          #
#                                                          #
############################################################
